NO ./xpm/test_wall_north.xpm
SO ./xpm/test_wall_south.xpm
WE ./xpm/test_wall_west.xpm
EA ./xpm/test_wall_east.xpm

F 220,100,0
C 135,206,250

    11111  11111111
111111001111
1010001111111111111111111111B1111111B11111111111111111111111
1B000000000000000000000100000001000000001011111111111111111
10000000000001100000000000100000000000001000D00000000000001
1000000B011111111000000100000000010000000000111111111111111
111D111111111111111111111111B111111111111111111111111111111
11101
111N1
1111111111111111
