NO ./xpm/test_wall_north.xpm
SO ./xpm/test_wall_south.xpm
WE ./xpm/test_wall_west.xpm
EA ./xpm/test_wall_east.xpm

F 220,100,0
C 135,206,250

    11111  11111111
111111001111
10100011BBBB
11000000000011          
100S000000011111111
100D0000B011111111
111D1111111
111D1
11101
1111111111111111
