NO ./xpm/test_wall_north.xpm
SO ./xpm/test_wall_south.xpm
WE ./xpm/test_wall_west.xpm
EA ./xpm/test_wall_east.xpm

F 220,100,0
C 135,206,250

1111111111111
11111100111111
101 110111
1101001          
100S00011111111
1000000000011111111
1111111111111111
