NO ./xpm/test_wall_north.xpm
SO ./xpm/test_wall_south.xpm
WE ./xpm/test_wall_west.xpm
EA ./xpm/test_wall_east.xpm

F 220,100,0
C 135,206,250

    11111  11111111
111111001111  11
101 110111
1100001          
100S00011111111
1000000000011111111
1111111111111111
