NO ./xpm/test_wall_north.xpm
SO ./xpm/test_wall_south.xpm
WE ./xpm/test_wall_west.xpm
EA ./xpm/test_wall_east.xpm

F 220,100,0
C 135,206,250

11111111111111111111111111111111111111111111111111111111111
111111111111111111111111111111111111111111111111111111111111
110000000000000000000000000000000001100000000000000000000011
110000111111111111110000111111100001100001100001111111111111
110000110111111110110000111101100001100001100000111111111011
110000110000000000110000000001100001100001100000000000000011
110000110000110000111111100001110011100001100001111110000011
110000000000110000110000000001111011100001100001100000000011
111111111111110000110000100001111111100001100001111111111111
111111111111110000110001100001111111100001100001111111111111
1E0000000000000000110001100001100000000001100000000000000011
111111111111111111110001100001100001111111111111111110000011
111111111111111111110001100001100001111111111111111110000011
110000000000000000110001100001100001100000000000000000000011
111111111111100000110001100001100001100001111111111111111111
111110000000000000110001100001111111100000000000000000000011
111100111111111111100001000011111101111111111111111111111111
111100011111111111100001100001111001111111111111111111111111
111110000000000000000000100001111100000000000000000000000111
111111111111111111100000100001111111111111111111111110000011
111111111111111111100000100001111111111111111111111110000111
110000000000000000000000100001100000000000000001100000001111
111111111111111111111111100001111111111111001111100111111111
110000000000000000111100100001100000000000000000000000000011
110000011111111111111110010000110000011111111111111111111111
110000011111111111111110100001100001111111111111111111111111
110000000000000000111110100000000001110000000111000000000011
111111111111110000111110111111000001100001101111111110000011
111111111111110000110000111111000001100001111111111110000011
110000000000110000111100100000000001100001100000000000000011
110000111111110000111100111111000001100001111111111111111111
110000000000110000111100111000001101100000000000000000000011
111111100000110000111100110000011101101110000000111111000011
111111110000110000110000100001111111111111100001111111110011
110000110000110000111100100001111000000001100001100000000011          111111111111
110000110000110000110000100001110001100001100001100001111111          100000000001
1100000100001100001111001100001000111000011000011000111111111111111111100000000001
1100000000001100001110001110000001111000011000011000111000000000000000000000100001
1100001100001100001100001111111111111000011000011000110000111111111111100000000001
110000110000000000110001111111111110000000000011100000000011          100000000001
110000110000000000111000000000000000000000000111110000000011          111111111111
111111111111111111111111111111111111111111111111111111111111