NO ./xpm/test_wall_north.xpm
SO ./xpm/test_wall_south.xpm
WE ./xpm/test_wall_west.xpm
EA ./xpm/test_wall_east.xpm
F 220,100,0
C 135,206,250
1111111111111111111111111
1000000000110000000000001
1011000001110000000000001
100100000000000000000000111111111
11111111101100E001110000000000001
1000000000111111001110111111111111
11110111111    11100000010001
11110111111    11101010010001
11000000110    11100000010001
10000000000000001100000010001
10000000000000001101010010001
11000001110101011111011110001
11110111111010110111101000111
11111111111111111111111111111
